11111111111111111111
101100111011100E0001
10110001000100111101
10000100010001111101
101100P0111001001001
1E110000111000011001
10111100010001011101
10011101010101000001
00000001000100001111
11110101101101011111
100001000000010E0011
10111101011101111011
10111100001101111011
100E0001100000S00011
11111111111111111111