11111111111111111111
1P0000000E0000000001
100000S0000000000001
10011111000111111101
10011111000111111101
10S00000000000000101
10000000000000000101
10011111000111111101
100111110001111111E1
1E011111000111111101
10000000000000000101
10011111000111111101
100E0000000000000001
100000S0000000000001
11111111111111111111