11111111111111111111
10101000000000000001
10101000000000000001
10101000000000000001
10101000000000000001
10100000000000000001
10100000000000000001
10000000000000000001
10001000000000000001
10101000000000000001
10101000010000000001
10101010010000000001
10111111011100000001
10000000000000000001
11111111111111111111