11111111111111111111
101010E000E0000E0001
10101000000000000001
101010000E0000000001
10101000000000000P01
101000000S0000000001
10100000000000000001
100000E0000000000001
10001000000000000001
10101000000000000001
10101000010000000001
10101010010000E00001
10111111011100000001
10000E00000000S00E01
11111111111111111111