11111111111111111111
11000000000000000011
11000000000000000011
11000000000000000011
11000000000000000011
11000000000000000011
11000000000000000011
11000000000000000011
11000000000000000011
110000P0000000000011
11000000000000000011
11000000000000000011
11000000000000000011
11111111111111111111
11111111111111111111