11111111111111111111
10101000000000000001
10101000000000000001
101010000E0000000001
10101000000000000P01
10100000000000000001
10100000000000000001
100000E0000000000001
10001000000000000001
10101000000000000001
10101000010000000001
10101010010000E00001
10111111011100000001
10000E00000000000E01
11111111111111111111