11111111111111111111
10000000000000000001
100000S0010000000001
10011110010011111001
10011110010011111001
10S00000010000000001
10000000000000000001
10011110000011111001
10011110010011111001
1E000000010000000001
10000000010000000001
10011110010011110001
1000000001000P00S001
100000S0000000000001
11111111111111111111