11111111111111111111
11  1111111111  1111
11     1111      111
11    111   1111  11
      111   1111    
11    111   111   11
11    11         111
111       P      111
1111              11
1111             111
111       11     111
          11        
1111     111      11
11111   11111  11111
11111111111111111111