11111111111111111111
10000000000000000001
10000000000000000001
10000000000000000001
10000000000000000001
100S00000000000E0001
10000000000000000001
10000010010000000001
10000010010000000001
10000010010000000001
10000010010000000001
10000000000000000001
1000P000000000000001
10000000000000000001
11111111111111111111
